F 200,12,32
NO ./path
C 255,255,0
WE .path
SO .path
E .path

     11111111111111111111
     10000110000000000001
1111110000110000000000001
100E000000110000000000001
1000000000110000000000001
1000000000000000000000001
1000000000110000000000001
1000000000110000000111111
10000000001100000001     
11111111111110111111     
1000000000010000000111111
1000000000010000000000001
1000000000000000000000001
1111111111111111111111111
